Tuning DADFAD


[Intro]

D|----------------------------0-----------------------------------------------|
A|-------------------------------3--------------------------------------------|
F|----------------------------------4-----------------------------------------|
D|-3--0--2--0-----------0--------------0--------------------------------------|
A|-------------3--0--2--------------------------------------------------------|
D|-------------------------0--------------------------------------------------|


[Verse]

D|----------------------------------------------------------------------------|
A|----------------------------------------------------------------------------|
F|----------------------------------------------------------------------------|
D|------0-3-----------3---0-----------------------------5\4-(0)---------------|
A|--0-3-------0-3---0---------0-2-0-3---0-2-0-----0-2-------------------------|
D|--------------------------------------------5-------3-------0---------------|

D|------0--------------0--------------0------------------------------------------|
A|------0--------------0--------------0------------------------------------------|
F|------0--------------0--------------0------------------------------------------|
D|-5/7\5-5\4-(0)--5/7\5-5\4-(0)--5/7\5-5\4-(0)-----------------------------------|
A|-------------------------------------------------------------------------------|
D|-------------0---------------0---------------0---------------------------------|

D|---------------------0--0---------------------------------------------------|
A|---------------0-2-0-3----3-------------------------------------------------|
F|---------------------4------4-----------------------------------------------|
D|---0---0---0------------------0---------------------------------------------|
A|-3---2---1---0--------------------------------------------------------------|
D|----------------------------------------------------------------------------|

D|----------------------------------------------------------------------------|
A|----------------------------------------------------------------------------|
F|----------------------------------------------------------------------------|
D|-----0-3-----0-2-----0-3-2---0---------------------------------5\4-(0)------|
A|-0-3-------0-3-----0-3-----3-------0-2-0-3---0-2-0-----0-2-0----------------|
D|-------------------------------0-------------------5---------3-------0------|



************************************

|(_)   Left hand pluck.
| /    Slide up
| \    Slide down

************************************