[Intro]

e|-----------------------0-0-0-------------------------------|
B|---1---------1-1-------1-1-1--1---3-3-3--0--3-3-3--1-0-----|
G|---2-----2-2-----2-2--------------0-0-0--0--0-0-0--0-0-----|
D|-------------2-2--------------2----------0-----------------|  x4
A|---0-----0-0-----0-0---3-----------------------------------|
E|----------------------------------3---------3------1-------|